#S###################
#...................#
##......##..........#
##.....###..........#
#..###...#..........#
############..#######
#####...............#
#.....##............#
#..#................#
###########E#########